Columns: 30
Rows: 20
000000000000000000000000000000
000000020000000001111111110000
000000000000000000111111111000
000000000000000000001111111000
000000340000000000000111110000
000000560000000000000000000000
000000340000003434343434000000
000000560000005656565656000000
000000000000003400000000000000
000000000000005600002000000000
000000000000003400000000000000
000000000000005600000000000000
000000343434343400000034000000
000000565656565600000056000000
000000000000000000000034000000
000000000000000000000056000000
000000000000000000000000000000
000000000000000000000000000000
000000000000000000000000000000
000000000000000000000000000000